#R##################
#000000000000000000#
#000000000000000####
#000000000000000000#
#000000000000000000#
#0000000###00000000#
#000000000000000000#
#000###000000000000#
#000000000000000000#
##################S#
