#R##################
#000000000000000000#
#000000000000000####
#0###############00#
#00#000#00000000000#
#0##0#############0#
#00#000000000000000#
#00####000000000000#
#000000000000000000#
##################S#
